7 9
#########
#........
#.#######
#.......#
#######.#
........#
#########