7 9
#########
#...#....
###.#.###
#.......#
#.#####.#
........#
#########