7 9
#########
#........
#.#####.#
#.#...#.#
#.#.#.#.#
....#...#
#########
